┌──────────────────────────────────────────────────────────────────────────────┐
│                                                                              │
│                                                                              │
│                                                                              │
│                                                                              │
│                                                                              │
│                                                                              │
│                                                                              │
│                                 LEVEL SELECT                                 │
│                                                                              │
│                                                                              │
├──┤ SCORES ├───────────┬──────────────────────────────┬─────────────┤ INFO ├──┤
│                       │                              │                       │
│                       │                              │                       │
│                       │                              │                       │
│                       │                              │                       │
│                       │                              │                       │
│                       │                              │                       │
│                       │                              │                       │
│                       │                              │                       │
│                       │                              │                       │
│                       │                              │                       │
│                       │                              │                       │
│                       │                              │                       │
│                       │                              │                       │
│                       │                              │                       │
│                       │                              │                       │
│                       │                              │                       │
│                       │                              │                       │
│                       │                              │                       │
│                       │                              │                       │
│                       │                              │                       │
│                       │                              │                       │
│                       │                              │                       │
│                       │                              │                       │
│                       │                              │                       │
│                       │                              │                       │
│                       │                              │                       │
│                       │                              │                       │
│                       │                              │                       │
│                       │                              │                       │
│                       │                              │                       │
│                       │                              │                       │
│                       │                              │                       │
│                       │                              │                       │
│                       │                              │                       │
│                       │                              │                       │
│                       │                              │                       │
│                       │                              │                       │
│                       │                              │                       │
├───────────────────────┴──────────────────────────────┴───────────────────────┤
│                                                                              │
│                                                                              │
│                                                                              │
│                                                                              │
│                                                                              │
│                                                                              │
│                                                                              │
│                                                                              │
└──────────────────────────────────────────────────────────────────────────────┘
