────────────────────────┐
│
│
│
│
│
│
│
│
│
│
┬─────────────┤ INFO ├──┤
│                       │
│                       │
│                       │
│                       │
│                       │
│                       │
│                       │
│                       │
│                       │
│                       │
│                       │
│                       │
│                       │
│                       │
│                       │
│                       │
│                       │
│                       │
│                       │
│                       │
│                       │
│                       │
│                       │
│                       │
│                       │
│                       │
│                       │
│                       │
│                       │
│                       │
│                       │
│                       │
│                       │
│                       │
│                       │
│                       │
│                       │
│                       │
┴───────────────────────┤
│
│
│
│
│
│
│
│
────────────────────────┘